#######################################
#######################################
#######################################
###.................................###
###.................................###
###.................................###
###.................................###
###.................................###
###...............###...............###
###...............#A#...............###
###...............#.#...............###
###.................................###
###.................................###
###.................................###
###............###..................###
###............#A...................###
###............###..................###
###.................................###
###.................................###
###.................................###
###.................................###
###.................................###
###.................................###
###.................................###
###.................................###
###.................................###
###.................................###
#######################################
#######################################
#######################################
