#######################################
#######################################
#######################################
###.................................###
###.................................###
###.................................###
###.................................###
###.................................###
###...............###...............###
###...............#B#...............###
###...............#.#...............###
###.................................###
###.................................###
###.................................###
###............###..................###
###............#R...................###
###............###..................###
###.................................###
###.................................###
###.................................###
###.................................###
###.................................###
###.................................###
###.................................###
###.................................###
###.................................###
###.................................###
#######################################
#######################################
#######################################
