###S###
#.....#
#.###.#
#..B#.#
#.###.#
#.....#
#######
